,Rank,Year,Movie,WorldwideBox Office,DomesticBox Office,InternationalBox Office
0,1,2009,Avatar,2845899541,760507625,2085391916
1,2,2019,Avengers: Endgame,2797800564,858373000,1939427564
2,3,1997,Titanic,2207986545,659363944,1548622601
3,4,2015,Star Wars Ep. VII: The Force Awakens,2064615817,936662225,1127953592
4,5,2018,Avengers: Infinity War,2044540523,678815482,1365725041
5,6,2015,Jurassic World,1669979967,652306625,1017673342
6,6,2021,Spider-Man: No Way Home,1850476678,780418859,1070057819
7,8,2015,Furious 7,1516881526,353007020,1163874506
8,9,2012,The Avengers,1515100211,623357910,891742301
9,10,2019,Frozen II,1446925396,477373578,969551818
10,11,2015,Avengers: Age of Ultron,1395316979,459005868,936311111
11,12,2018,Black Panther,1336494321,700059566,636434755
12,13,2011,Harry Potter and the Deathly Hallows:…,1334392544,381193157,953199387
13,14,2017,Star Wars Ep. VIII: The Last Jedi,1331635141,620181382,711453759
14,15,2018,Jurassic World: Fallen Kingdom,1308334005,417719760,890614245
15,16,2013,Frozen,1266648320,400953009,865695311
16,17,2017,Beauty and the Beast,1255080655,504014165,751066490
17,18,2018,Incredibles 2,1242805359,608581744,634223615
18,19,2017,The Fate of the Furious,1236703796,225764765,1010939031
19,20,2013,Iron Man 3,1215392272,408992272,806400000
20,21,2015,Minions,1159631140,336045770,823585370
21,22,2016,Captain America: Civil War,1151918521,408084349,743834172
22,23,2018,Aquaman,1143758700,335061807,808696893
23,24,2019,Spider-Man: Far From Home,1131113066,390532085,740580981
24,25,2019,Captain Marvel,1129727388,426829839,702897549
25,26,2011,Transformers: Dark of the Moon,1123794079,352390543,771403536
26,27,2003,The Lord of the Rings: The Return of …,1120214046,377845905,742368141
27,28,2012,Skyfall,1110526981,304360277,806166704
28,29,2014,Transformers: Age of Extinction,1104054072,245439076,858614996
29,30,2012,The Dark Knight Rises,1082228107,448139099,634089008
30,31,2019,Toy Story 4,1073080329,434038008,639042321
31,32,2019,Star Wars: The Rise of Skywalker,1072848487,515202542,557645945
32,33,2019,Joker,1072507517,335451311,737056206
33,34,2010,Toy Story 3,1068879522,415004880,653874642
34,35,2006,Pirates of the Caribbean: Dead Manâs …,1066179725,423315812,642863913
35,36,2016,Rogue One: A Star Wars Story,1055135598,532177324,522958274
36,37,2019,Aladdin,1046649706,355559216,691090490
37,38,2011,Pirates of the Caribbean: On Stranger…,1045713802,241071802,804642000
38,39,1993,Jurassic Park,1045573035,402523348,643049687
39,40,2017,Despicable Me 3,1032596894,264624300,767972594
40,41,1999,Star Wars Ep. I: The Phantom Menace,1027044677,474544677,552500000
41,42,2010,Alice in Wonderland,1025491110,334191110,691300000
42,43,2016,Finding Dory,1025006125,486295561,538710564
43,44,2012,The Hobbit: An Unexpected Journey,1014938545,303003568,711934977
44,45,2016,Zootopia,1005304638,341268248,664036390
45,46,2008,The Dark Knight,999046281,533720947,465325334
46,47,1994,The Lion King,986214868,421785283,564429585
47,48,2013,Despicable Me 2,975216835,368065385,607151450
48,49,2001,Harry Potter and the Sorcererâs Stone,965054122,317871467,647182655
49,50,2017,Jumanji: Welcome to the Jungle,961613199,404508916,557104283
50,51,2007,Pirates of the Caribbean: At Worldâs …,960996492,309420425,651576067
51,52,2013,The Hobbit: The Desolation of Smaug,959358436,258241522,701116914
52,53,2010,Harry Potter and the Deathly Hallows:…,955371891,296131568,659240323
53,54,2016,The Jungle Book,953554418,364001123,589553295
54,55,2014,The Hobbit: The Battle of the Five Ar…,941560732,255119788,686440944
55,56,2007,Harry Potter and the Order of the Pho…,940743940,292137260,648606680
56,57,2003,Finding Nemo,936094852,380529370,555565482
57,58,2004,Shrek 2,935253978,441226247,494027731
58,59,2009,Harry Potter and the Half-Blood Prince,930673167,302089278,628583889
59,60,2002,The Lord of the Rings: The Two Towers,919148764,342548984,576599780
60,61,2007,Spider-Man 3,894860230,336530303,558329927
61,62,2018,Bohemian Rhapsody,891472999,216303339,675169660
62,63,2005,Harry Potter and the Goblet of Fire,891320084,290201752,601118332
63,64,2001,The Lord of the Rings: The Fellowship…,891216824,315544750,575672074
64,65,2009,Ice Age: Dawn of the Dinosaurs,886686817,196573705,690113112
65,66,2016,The Secret Life of Pets,885302500,368384330,516918170
66,67,2017,Spider-Man: Homecoming,880166350,334201140,545965210
67,68,2012,Ice Age: Continental Drift,879765137,161321843,718443294
68,69,2015,Spectre,879500760,200074175,679426585
69,70,2002,Harry Potter and the Chamber of Secrets,876508805,262233381,614275424
70,71,2016,Batman v Superman: Dawn of Justice,872395091,330360194,542034897
71,72,2017,Guardians of the Galaxy Vol 2,869113101,389813101,479300000
72,73,2013,The Hunger Games: Catching Fire,864868047,424668047,440200000
73,74,2015,Inside Out,855038387,356461711,498576676
74,75,2018,Venom,853530899,213511408,640019491
75,76,2017,Thor: Ragnarok,850482778,315058289,535424489
76,77,2005,Star Wars Ep. III: Revenge of the Sith,848998877,380270577,468728300
77,78,2021,"Ni Hao, Li Huan Ying",841716512,nan,841716512
78,79,2009,Transformers: Revenge of the Fallen,836519699,402111870,434407829
79,80,2017,Zhan Lang 2,835474171,2721100,832753071
80,81,2012,"The Twilight Saga: Breaking Dawn, Part 2",829724737,292324737,537400000
81,82,2002,Spider-Man,821706375,403706375,418000000
82,83,2017,Wonder Woman,818058221,412563408,405494813
83,84,1996,Independence Day,817400878,306169255,511231623
84,85,2016,Fantastic Beasts and Where to Find Them,811724385,234037575,577686810
85,86,2007,Shrek the Third,807330936,322719944,484610992
86,87,2019,Jumanji: The Next Level,800128637,316831246,483297391
87,88,2017,Coco,798237597,210460015,587777582
88,89,2017,Pirates of the Caribbean: Dead Men Te…,794861794,172558876,622302918
89,90,2004,Spider-Man 2,794697557,373524485,421173072
90,91,1982,E.T. the Extra-Terrestrial,792962972,435110554,357852418
91,92,2004,Harry Potter and the Prisoner of Azkaban,789961033,249757726,540203307
92,93,2013,Fast and Furious 6,789300444,238679850,550620594
93,94,2018,Mission: ImpossibleâFallout,787176729,220159104,567017625
94,95,2008,Indiana Jones and the Kingdom of the …,786635413,317101119,469534294
95,96,2018,Deadpool 2,786362370,324591735,461770635
96,97,2016,Deadpool,784157111,363070709,421086402
97,98,1977,Star Wars Ep. IV: A New Hope,775398007,460998007,314400000
98,99,2014,Guardians of the Galaxy,770882395,333714112,437168283
99,100,2006,The Da Vinci Code,767820459,217536138,550284321
100,102,2019,Fast & Furious Presents: Hobbs & Shaw,760381706,173956935,586424771
101,103,2014,Maleficent,758536735,241407328,517129407
102,104,2012,The Amazing Spider-Man,757890267,262030663,495859604
103,105,2009,2012,757677748,166112167,591565581
104,106,2010,Shrek Forever After,756244673,238736787,517507886
105,107,2014,X-Men: Days of Future Past,747862775,233921534,513941241
106,108,2012,Madagascar 3: Europe's Most Wanted,746921271,216391482,530529789
107,109,2016,Suicide Squad,746846894,325100054,421746840
108,110,2013,Monsters University,743455810,268488329,474967481
109,111,2019,Ne Zha Zhi Mo Tong Jiang Shi,742711251,3695533,739015718
110,112,2003,The Matrix Reloaded,738576929,281553689,457023240
111,113,2009,Up,731463377,293004164,438459213
112,114,2010,Inception,728582465,292576195,436006270
113,115,2019,Liu Lang Di Qiu,727846450,5875487,721970963
114,116,2005,"The Chronicles of Narnia: The Lion, t…",720539572,291710957,428828615
115,117,2014,Captain America: The Winter Soldier,714401889,259746958,454654931
116,118,2014,Dawn of the Planet of the Apes,710644566,208545589,502098977
117,119,2014,The Amazing Spider-Man 2,708996336,202853933,506142403
118,120,2007,Transformers,708272592,319246193,389026399
119,121,2010,The Twilight Saga: Eclipse,706102828,300531751,405571077
120,122,2017,It,701083042,328828874,372254168
121,123,2021,Tang Ren Jie Tan An 3,698994069,nan,698994069
122,124,2011,Mission: ImpossibleâGhost Protocol,694713230,209397903,485315327
123,125,2013,Gravity,689742192,274092705,415649487
124,126,2011,"The Twilight Saga: Breaking Dawn, Part 1",689420051,281287133,408132918
125,127,2015,Mission: ImpossibleâRogue Nation,688858992,195042377,493816615
126,128,2009,The Twilight Saga: New Moon,687557727,296623634,390934093
127,129,1994,Forrest Gump,679838260,330151138,349687122
128,130,2012,The Hunger Games,677923379,408010692,269912687
129,131,2016,Doctor Strange,676354481,232641920,443712561
130,132,1999,The Sixth Sense,672806292,293506292,379300000
131,133,2013,Man of Steel,667999518,291045518,376954000
132,134,2011,Kung Fu Panda 2,664837547,165249063,499588484
133,135,2021,F9: The Fast Saga,662412771,171456615,490956156
134,136,2002,Star Wars Ep. II: Attack of the Clones,656695615,310676740,346018875
135,137,2017,Justice League,655945209,229024295,426920914
136,138,2015,The Martian,655111538,228433663,426677875
137,139,2003,Pirates of the Caribbean: The Curse o…,654310819,305410819,348900000
138,140,2012,Men in Black 3,654213485,179020854,475192631
139,141,2014,Interstellar,651994868,188017894,463976974
140,142,2006,Ice Age: The Meltdown,651899282,195330621,456568661
141,143,2018,Fantastic Beasts: The Crimes of Grind…,651280475,159555901,491724574
142,144,2014,Big Hero 6,649657407,222527828,427129579
143,145,2015,The Hunger Games: Mockingjay - Part 2,648986787,281723902,367262885
144,146,2013,Thor: The Dark World,644602516,206362140,438240376
145,147,2016,Moana,635245959,248757044,386488915
146,148,2016,Sing,632483611,270329045,362154566
147,149,2008,Kung Fu Panda,631910531,215434591,416475940
148,150,2004,The Incredibles,631441092,261441092,370000000
149,151,2011,Fast Five,630163454,210031325,420132129
150,152,2007,Ratatouille,626549695,206445654,420104041
151,153,2008,Hancock,624234272,227946274,396287998
152,154,2018,Ant-Man and the Wasp,623144660,216648740,406495920
153,155,2004,The Passion of the Christ,622313635,370782930,251530705
154,156,2010,Iron Man 2,621156389,312433331,308723058
155,157,2012,Life of Pi,619310368,124987022,494323346
156,158,1997,The Lost World: Jurassic Park,618638999,229086679,389552320
157,159,2014,How to Train Your Dragon 2,614586270,177002924,437583346
158,160,2017,Logan,614202315,226277068,387925247
159,161,2005,War of the Worlds,606836535,234280354,372556181
160,162,2017,Transformers: The Last Knight,602893340,130168683,472724657
161,163,2008,Mamma Mia!,602891655,144130063,458761592
162,164,2008,Madagascar: Escape 2 Africa,599680774,180174880,419505894
163,165,2006,Casino Royale,594420283,167365000,427055283
164,166,2008,Quantum of Solace,591692078,169368427,422323651
165,167,1997,Men in Black,587790539,250690539,337100000
166,168,2011,The Hangover Part II,586764305,254464305,332300000
167,169,2010,Tangled,585574317,200821936,384752381
168,170,2007,I am Legend,585532684,256393010,329139674
169,171,2008,Iron Man,585171547,318604126,266567421
170,172,2006,Night at the Museum,579446407,250863268,328583139
171,173,2018,Ready Player One,579055653,137690172,441365481
172,174,2013,The Croods,573068425,187168425,385900000
173,175,2015,Fifty Shades of Grey,570794950,166167230,404627720
174,176,2011,The Smurfs,563749323,142614158,421135165
175,177,2017,Kong: Skull Island,561072059,168052812,393019247
176,178,2001,"Monsters, Inc.",560483719,290149425,270334294
177,179,2011,Cars 2,560155383,191450875,368704508
178,180,2005,Madagascar,556559566,193595521,362964045
179,181,2012,Ted,556016627,218665740,337350887
180,182,2004,The Day After Tomorrow,555840117,186740799,369099318
181,183,2011,Puss in Boots,554987477,149260504,405726973
182,184,2012,Brave,554606532,237282182,317324350
183,185,1998,Armageddon,554600000,201578182,353021818
184,186,2005,King Kong,550517357,218080025,332437332
185,187,2000,Mission: Impossible 2,549588516,215409889,334178627
186,188,1980,Star Wars Ep. V: The Empire Strikes Back,549001242,291738960,257262282
187,189,2014,American Sniper,547326372,350126372,197200000
188,190,2018,Tang Ren Jie Tan An 2,544068574,1983984,542084590
189,191,2010,Despicable Me,543464573,251513985,291950588
190,192,2016,X-Men: Apocalypse,542537546,155442489,387095057
191,193,2011,Sherlock Holmes: A Game of Shadows,535663443,186848418,348815025
192,194,2015,Cinderella,534551353,201151353,333400000
193,195,2018,Hong Hai Xing Dong,533601535,1543547,532057988
194,196,2015,The Revenant,532938302,183637894,349300408
195,197,2008,WALL-E,532508025,223808164,308699861
196,198,2013,World War Z,531861650,202706711,329154939
197,199,2018,Ralph Breaks The Internet,529290830,201091711,328199119
198,200,2014,Godzilla,529076069,200676069,328400000
199,202,2018,The Meg,527370715,145443742,381926973
200,203,2018,Hotel Transylvania 3: Summer Vacation,527103195,167500092,359603103
201,204,2007,The Simpsons Movie,527071022,183135014,343936008
202,205,2016,Mei Ren Yu,525018479,3229457,521789022
203,206,2019,How to Train Your Dragon: The Hidden …,522746363,160799505,361946858
204,207,2016,Kung Fu Panda 3,521170825,143528619,377642206
205,208,2017,Dunkirk,519452014,190068280,329383734
206,209,2015,Ant-Man,518858449,180202163,338656286
207,210,1990,Ghost,517600000,217631306,299968694
208,211,2004,Meet the Fockers,516567575,279167575,237400000
209,212,1991,Terminator 2: Judgment Day,515390883,203464105,311926778
210,213,2018,Dr. Seussâ The Grinch,514602427,270834950,243767477
211,214,1999,Toy Story 2,511358276,245852179,265506097
212,215,1992,Aladdin,504050219,217350219,286700000
213,216,2009,Sherlock Holmes,498438212,209028679,289409533
214,217,2012,Wreck-It Ralph,496511521,189412677,307098844
215,218,1996,Twister,495700000,241688385,254011615
216,219,2010,How to Train Your Dragon,494870992,217581232,277289760
217,220,2010,Clash of the Titans,493214888,163214888,330000000
218,221,2014,Rio 2,492846291,131538435,361307856
219,222,2001,Shrek,491812794,267655011,224157783
220,223,2009,Angels & Demons,490875846,133375846,357500000
221,224,2013,Oz the Great and Powerful,490359051,234770996,255588055
222,225,2017,War for the Planet of the Apes,489592267,146880162,342712105
223,226,2019,Maleficent: Mistress of Evil,489346495,113929605,375416890
224,227,2011,Rio,487519809,143619809,343900000
225,228,2005,Mr. and Mrs. Smith,486124090,186336279,299787811
226,229,1998,Saving Private Ryan,485035085,216335085,268700000
227,230,2014,Teenage Mutant Ninja Turtles,485004754,191204754,293800000
228,231,2012,Les Intouchables,484630908,13182281,471448627
229,232,2003,Bruce Almighty,484468608,242704995,241763613
230,233,2004,Troy,483152040,133298577,349853463
231,234,2020,Kimetsu no Yaiba: Mugen Ressha-Hen,477926595,47700000,430226595
232,235,1990,Home Alone,476684675,285761243,190923432
233,236,2005,Charlie and the Chocolate Factory,475825484,206459076,269366408
234,237,1983,Star Wars Ep. VI: Return of the Jedi,475106177,309205079,165901098
235,238,1989,Indiana Jones and the Last Crusade,474171806,197171806,277000000
236,239,2020,Ba bai,472643830,nan,472643830
237,240,2011,Rise of the Planet of the Apes,470986200,176760185,294226015
238,241,1975,Jaws,470700000,260000000,210700000
239,242,2019,It: Chapter Two,469566806,211593228,257973578
240,243,2015,Hotel Transylvania 2,469500298,169700110,299800188
241,244,2014,The Lego Movie,468084718,257784718,210300000
242,245,2021,Godzilla vs. Kong,467863133,100563133,367300000
243,246,2013,Star Trek Into Darkness,467381584,228778661,238602923
244,247,2009,The Hangover,465487583,277322503,188165080
245,248,2019,Wo he wo de zu guo,465418019,2323409,463094610
246,249,1999,The Matrix,465377200,173396389,291980811
247,250,2018,Bumblebee,465195589,127195589,338000000
248,251,2006,Cars,461630558,244082982,217547576
249,252,2006,X-Men: The Last Stand,459260946,234362462,224898484
250,253,1996,Mission: Impossible,457697994,180981886,276716108
251,254,2000,Gladiator,457552323,187683805,269868518
252,255,2014,Lucy,457507776,126573960,330933816
253,256,2007,National Treasure: Book of Secrets,457325804,219961501,237364303
254,257,2003,The Last Samurai,456810575,111110575,345700000
255,258,2015,San Andreas,456258539,155190832,301067707
256,259,2007,300,454161935,210614939,243546996
257,260,2018,Wo Bi Shi Yao Shen,451183392,6752,451176640
258,261,2001,Ocean's Eleven,450728529,183417150,267311379
259,262,2012,Django Unchained,449841566,162805434,287036132
260,263,2011,Thor,449326618,181030624,268295994
261,264,2001,Pearl Harbor,449239853,198539855,250699998
262,265,1999,Tarzan,448191819,171091819,277100000
263,266,2019,The Secret Life of Pets 2,446273015,158874395,287398620
264,267,2016,La La Land,445607848,151101803,294506045
265,268,2007,The Bourne Ultimatum,444043396,227471070,216572326
266,269,2009,Alvin and the Chipmunks: The Squeakquel,443483213,219614612,223868601
267,270,2002,Men in Black 2,441767803,190418803,251349000
268,271,1993,Mrs. Doubtfire,441286003,219195051,222090952
269,272,2016,Warcraft,438899824,47365290,391534534
270,273,1991,Beauty and the Beast,438656843,206333165,232323678
271,274,2012,Les MisÃ©rables,438420442,148809770,289610672
272,275,2001,The Mummy Returns,435040395,202007640,233032755
273,276,2017,The Greatest Showman,434473253,174340174,260133079
274,277,2020,Wo He Wo De Jia Xiang,433241288,nan,433241288
275,278,2003,Terminator 3: Rise of the Machines,433058296,150358296,282700000
276,279,1990,Pretty Woman,432566361,178406268,254160093
277,280,2015,Terminator: Genisys,432150894,89760956,342389938
278,281,2019,PokÃ©mon: Detective Pikachu,431947558,144105346,287842212
279,282,2002,Die Another Day,431942139,160942139,271000000
280,283,2018,A Star is Born,431870523,215288866,216581657
281,284,2010,The Kingâs Speech,430821168,138797449,292023719
282,285,1973,The Exorcist,428214478,230347346,197867132
283,286,2018,Rampage,427947217,101028233,326918984
284,287,2003,The Matrix Revolutions,427300260,139270910,288029350
285,288,2000,Cast Away,427230516,233632142,193598374
286,289,2020,Bad Boys For Life,424536881,204417855,220119026
287,290,1990,Dances with Wolves,424208805,184208842,239999963
288,291,2010,The Chronicles of Narnia: The Voyage …,418186950,104386950,313800000
289,292,2019,Zhongguo jizhang,417850370,706572,417143798
290,293,2008,The Chronicles of Narnia: Prince Caspian,417341288,141621490,275719798
291,294,2013,The Wolverine,416456852,132556852,283900000
292,295,1999,The Mummy,416385488,155385488,261000000
293,296,2016,Jason Bourne,416168316,162192920,253975396
294,297,2008,Sex and the City,415247258,152647258,262600000
295,298,1988,Rain Man,412800000,172825435,239974565
296,299,1989,Batman,411348924,251188924,160160000
297,300,2013,Pacific Rim,411002906,101802906,309200000
298,302,2017,The Mummy,409953905,80101125,329852780
299,303,2017,Kingsman: The Golden Circle,408803696,100234838,308568858
300,304,2002,Signs,408250578,227969295,180281283
301,305,2003,X-Men 2,406348630,214949694,191398936
302,306,2008,The Mummy: Tomb of the Dragon Emperor,405760225,102491776,303268449
303,307,2015,Kingsman: The Secret Service,404561724,128261724,276300000
304,308,2012,Prometheus,402448265,126477084,275971181
305,309,2008,Twilight,402280159,192769854,209510305
306,310,2009,Night at the Museum: Battle of the Sm…,402231063,177243721,224987342
307,311,2016,Ice Age: Collision Course,402156682,64063008,338093674
308,312,2019,Alita: Battle Angel,401900040,85838210,316061830
309,313,2012,Snow White and the Huntsman,401021746,155136755,245884991
310,314,2010,Tron: Legacy,399866199,172062763,227803436
311,315,2006,Mission: Impossible III,399387745,133501348,265886397
312,316,2018,Mamma Mia: Here We Go Again!,394201159,120634935,273566224
313,317,2018,Solo: A Star Wars Story,393151347,213767512,179383835
314,318,2006,Superman Returns,391081192,200120000,190961192
315,319,1939,Gone with the Wind,390525192,198680470,191844722
316,320,1991,Robin Hood: Prince of Thieves,390500000,165493908,225006092
317,321,2013,The Wolf of Wall Street,389918903,116949183,272969720
318,322,1978,Grease,387483897,181813770,205670127
319,323,2009,Star Trek,386839614,257730019,129109595
320,324,2002,Ice Age,386116343,176387405,209728938
321,325,2015,Home,385997896,177397510,208600386
322,326,1985,Back to the Future,385510205,212259762,173250443
323,327,2006,Happy Feet,385000317,198000317,187000000
324,328,2016,Independence Day: Resurgence,384169424,103144286,281025138
325,329,2008,Slumdog Millionaire,383825427,141330703,242494724
326,330,2001,Sen to Chihiro no Kamikakushi,383686091,10049886,373636205
327,331,2017,Cars 3,383541369,152901115,230640254
328,332,2019,Godzilla: King of the Monsters,383299915,110500138,272799777
329,333,2007,Live Free or Die Hard,382288147,134529403,247758744
330,334,2009,Monsters vs. Aliens,381687380,198351526,183335854
331,335,2017,Fifty Shades Darker,381367046,114434010,266933036
332,336,2012,Hotel Transylvania,378659142,148313048,230346094
333,337,2012,Taken 2,377807404,139854287,237953117
334,338,2019,Once Upon a Timeâ¦in Hollywood,377562039,142502728,235059311
335,339,1998,Godzilla,376000000,136314294,239685706
336,340,2013,G.I. Joe: Retaliation,375740705,122523060,253217645
337,341,2018,Spider-Man: Into The Spider-Verse 3D,375654619,190173195,185481424
338,342,2002,My Big Fat Greek Wedding,374890034,241438208,133451826
339,343,2009,X-Men Origins: Wolverine,374825760,179883157,194942603
340,344,2000,What Women Want,374105123,182805123,191300000
341,345,2011,The Adventures of Tintin,373993951,77591831,296402120
342,346,2018,Fifty Shades Freed,371985018,100407760,271577258
343,347,2004,Shark Tale,371741123,161412000,210329123
344,348,2011,Captain America: The First Avenger,370569776,176654505,193915271
345,349,1998,There's Something About Mary,369884651,176484651,193400000
346,350,2015,Mad Max: Fury Road,367457874,153636354,213821520
347,351,1981,Raiders of the Lost Ark,367452079,225686079,141766000
348,352,2007,The Golden Compass,367262558,70107728,297154830
349,353,2014,Gone Girl,367160781,167767189,199393592
350,354,2014,Edge of Tomorrow,367028980,100206256,266822724
351,355,2018,Xi Hong Shi Shou Fu,366961920,nan,366961920
352,356,2014,Penguins of Madagascar,366942531,83350911,283591620
353,357,2005,Hitch,366784257,177784257,189000000
354,358,2019,1917,366614721,159227644,207387077
355,359,1995,Die Hard: With a Vengeance,366101666,100012499,266089167
356,360,2001,Jurassic Park III,365900000,181166115,184733885
357,361,2009,Terminator Salvation,365491792,125322469,240169323
358,362,1994,True Lies,365300000,146282411,219017589
359,363,1995,Toy Story,365270951,192523233,172747718
360,364,1999,Notting Hill,363718196,116089678,247628518
361,365,2019,Shazam!,363664533,140371656,223292877
362,366,2018,The Nun,363391647,117450119,245941528
363,367,1998,A Bug's Life,363095319,162798565,200296754
364,368,2004,Ocean's Twelve,362989076,125531634,237457442
365,369,2007,Alvin and the Chipmunks,362605033,217326974,145278059
366,370,2001,Planet of the Apes,362211740,180011740,182200000
367,371,2013,The Hangover 3,362000072,112200072,249800000
368,372,2020,Tenet,361875852,57929000,303946852
369,373,1999,The World is Not Enough,361730660,126930660,234800000
370,374,2018,Zhuo yao ji 2,361683815,706153,360977662
371,375,2009,Fast & Furious,359347833,155064265,204283568
372,376,2015,Zhuo yao ji,359295591,32766,359262825
373,377,2005,Batman Begins,359004502,205343774,153660728
374,378,1992,Home Alone 2: Lost in New York,358994850,173585516,185409334
375,379,2002,Minority Report,358824714,132024714,226800000
376,380,1994,The Flintstones,358500000,130531208,227968792
377,381,2016,Kimi no na wa,357065738,5000181,352065557
378,382,1986,Top Gun,357011945,180012912,176999033
379,383,1995,Goldeneye,356429941,106429941,250000000
380,384,1999,American Beauty,356258047,130058047,226200000
381,385,2000,Dinosaur,356148063,137748063,218400000
382,386,2002,Catch Me if You Can,355612291,164606800,191005491
383,387,2011,X-Men: First Class,355408305,146408305,209000000
384,388,2014,Night at the Museum: Secret of the Tomb,353756621,113746621,240010000
385,389,1993,The Fugitive,353715317,183875760,169839557
386,390,2013,The Great Gatsby,353640419,144840419,208800000
387,391,2019,Dumbo,353166307,114766307,238400000
388,392,2014,Noah,352831065,101200044,251631021
389,393,1992,Basic Instinct,352700000,117727224,234972776
390,394,2016,The Angry Birds Movie,352327887,107509366,244818521
391,395,2021,Black Widow,352277006,175777006,176500000
392,396,2010,The Karate Kid,351774938,176591618,175183320
393,397,2017,Murder on the Orient Express,351767147,102826543,248940604
394,398,1994,The Mask,351620129,119920129,231700000
395,399,1988,Who Framed Roger Rabbit?,351500000,154112492,197387508
396,400,2012,Dr. Seussâ The Lorax,350976753,214030500,136946253
397,402,1998,Deep Impact,349464664,140464664,209000000
398,403,2011,Alvin and the Chipmunks: Chipwrecked,349088523,133107389,215981134
399,404,2016,The Legend of Tarzan,348902025,126643061,222258964
400,405,2018,Mary Poppins Returns,348901032,171958438,176942594
401,406,2004,"I, Robot",348629585,144801023,203828562
402,407,2013,The Smurfs 2,348547523,71017784,277529739
403,408,2014,The Maze Runner,348319861,102427862,245891999
404,409,2001,Rush Hour 2,347425832,226164286,121261546
405,410,1995,Pocahontas,347100000,141579773,205520227
406,411,2018,Peter Rabbit,346727372,115234093,231493279
407,412,2000,How the Grinch Stole Christmas,345445403,260348825,85096578
408,413,2017,xXx: Return of Xander Cage,345033359,44898413,300134946
409,414,2006,Over the Hedge,343397247,155019340,188377907
410,415,2016,Trolls,343242613,153707064,189535549
411,416,2013,Now You See Me,342769200,117723989,225045211
412,417,2008,Wanted,342416460,134508551,207907909
413,418,1977,Close Encounters of the Third Kind,340800479,169100479,171700000
414,419,2007,Enchanted,340384141,127706877,212677264
415,420,1997,Tomorrow Never Dies,339504276,125304276,214200000
416,421,1995,Batman Forever,336529144,184031112,152498032
417,422,2010,Prince of Persia: Sands of Time,336359676,90759676,245600000
418,423,1996,The Rock,336069511,134069511,202000000
419,424,1995,Apollo 13,335802271,173772767,162029504
420,425,2016,Star Trek Beyond,335673708,158848340,176825368
421,426,2018,A Quiet Place,334876670,188024361,146852309
422,427,2017,Never Say Die,334536622,nan,334536622
423,428,2016,The Great Wall,334486852,45157105,289329747
424,429,2015,The Good Dinosaur,333771037,123087120,210683917
425,430,2005,Fantastic Four,333132750,154696080,178436670
426,431,1984,Indiana Jones and the Temple of Doom,333080271,179880271,153200000
427,432,1989,Back to the Future Part II,331971881,118450002,213521879
428,433,2014,22 Jump Street,331333876,191719337,139614539
429,434,2004,National Treasure,331323410,173005002,158318408
430,435,2010,Black Swan,331266710,106954678,224312032
431,436,2014,300: Rise of an Empire,330780051,106580051,224200000
432,437,2000,Meet the Parents,330425040,166225040,164200000
433,438,2008,The Curious Case of Benjamin Button,329631958,127509326,202122632
434,439,2000,The Perfect Storm,328711434,182618434,146093000
435,440,2016,Now You See Me 2,328325007,65075540,263249467
436,441,1986,Crocodile Dundee,328203506,174803506,153400000
437,442,1995,Se7en,328125643,100125643,228000000
438,443,2008,Bolt,328015029,114053579,213961450
439,444,2015,Taken 3,327656424,89256424,238400000
440,445,2019,Feng Kuang De Wai Xing Ren,326150303,nan,326150303
441,446,2006,The Devil Wears Prada,326073155,124740460,201332695
442,447,2019,John Wick: Chapter 3 â Parabellum,325674995,171016727,154658268
443,448,1996,The Hunchback of Notre Dame,325500000,100138851,225361149
444,449,2010,Robin Hood,322459006,105487148,216971858
445,450,1993,Schindlerâs List,322197132,96898818,225298314
446,451,2010,Megamind,321887208,148415853,173471355
447,452,1987,Fatal Attraction,320100000,156645693,163454307
448,453,2018,Green Book,320029388,85080171,234949217
449,454,2010,The Last Airbender,319713881,131772187,187941694
450,455,1992,Lethal Weapon 3,319700000,144731527,174968473
451,456,2012,Journey 2: The Mysterious Island,318146162,103860290,214285872
452,457,2013,The Conjuring,317744402,137400141,180344261
453,458,2001,A Beautiful Mind,317668058,170708996,146959062
454,459,2009,Inglourious Basterds,316915264,120774594,196140670
455,460,1984,Beverly Hills Cop,316300000,234760478,81539522
456,461,2009,Disneyâs A Christmas Carol,315709697,137855863,177853834
457,462,1997,Air Force One,315268353,172956409,142311944
458,463,2009,The Proposal,314709717,163958031,150751686
459,464,1997,As Good as it Gets,314111923,148478011,165633912
460,465,2016,Resident Evil: The Final Chapter,314101190,26844692,287256498
461,466,2012,Battleship,313477717,65233400,248244317
462,467,2019,Knives Out,312952178,165364060,147588118
463,468,2017,Wonder,312755215,132422809,180332406
464,469,2004,The Polar Express,312719437,188578855,124140582
465,470,1999,Austin Powers: The Spy Who Shagged Me,312383487,206040085,106343402
466,471,2012,The Expendables 2,311979256,85028192,226951064
467,472,2007,Ocean's Thirteen,311744465,117144465,194600000
468,473,2015,The SpongeBob Movie: Sponge Out of Water,311013181,162994032,148019149
469,474,2004,The Bourne Supremacy,311001124,176087450,134913674
470,475,2010,Little Fockers,310650574,148438600,162211974
471,476,2017,The Lego Batman Movie,310570560,175750384,134820176
472,477,2015,Maze Runner: The Scorch Trials,310566162,81697192,228868970
473,478,2016,The Conjuring 2: The Enfield Poltergeist,310201399,102470008,207731391
474,479,1999,Runaway Bride,310138178,152257509,157880669
475,480,2005,Chicken Little,310043823,135386665,174657158
476,481,1996,Ransom,308700000,136492681,172207319
477,482,2017,Qian Ren 3: Yan Zhi Da Zuo Zhan,307547824,837791,306710033
478,483,2006,The Pursuit of Happyness,307311093,162586036,144725057
479,484,2014,The Fault in Our Stars,307166834,124872350,182294484
480,485,2012,Rise of the Guardians,306900902,103412758,203488144
481,486,2002,Chicago,306770545,170687518,136083027
482,487,2009,The Blind Side,305705794,255959475,49746319
483,488,2017,Annabelle: Creation,305384865,102092201,203292664
484,489,2012,Wrath of the Titans,305270083,83670083,221600000
485,490,2016,Dangal,305149461,12391761,292757700
486,491,2020,Sonic The Hedgehog,304961681,146066470,158895211
487,492,2018,Skyscraper,304868961,68420120,236448841
488,493,2013,A Good Day to Die Hard,304249198,67349198,236900000
489,494,1996,101 Dalmatians,304200000,136189294,168010706
490,495,1998,Mulan,303500000,120620254,182879746
491,496,1997,Liar Liar,302710615,181410615,121300000
492,497,2009,G.I. Joe: The Rise of Cobra,302469017,150201498,152267519
493,498,2016,Passengers,302239672,100014699,202224973
494,499,1991,Hook,300854823,119654823,181200000
495,500,1985,Rambo: First Blood Part II,300400000,150415432,149984568
496,502,1978,Superman,300200000,134218018,165981982
497,503,2004,Van Helsing,300150546,120150546,180000000
498,504,2008,Horton Hears a Who,299477886,154529439,144948447
499,505,2010,Shutter Island,299461782,128012934,171448848
500,506,1997,My Best Friend's Wedding,298923419,126813153,172110266
501,507,1999,Stuart Little,298815224,140015224,158800000
502,508,2018,Oceanâs 8,297718711,140218711,157500000
503,509,1989,Look Who's Talking,297100000,140088813,157011187
504,510,2000,X-Men,296872367,157299717,139572650
505,511,2002,Austin Powers in Goldmember,296338663,213117789,83220874
506,512,2016,Miss Peregrineâs Home for Peculiar Ch…,295986876,87242834,208744042
507,513,2010,Resident Evil: Afterlife,295874190,60128566,235745624
508,514,1984,Ghostbusters,295211811,242212467,52999344
509,515,2015,The Divergent Series: Insurgent,295075882,130179072,164896810
510,516,2010,Sex and the City 2,294680778,95347692,199333086
511,517,1998,Doctor Dolittle,294156605,144156605,150000000
512,518,2009,G-Force,292817841,119436770,173381071
513,519,2018,Pacific Rim: Uprising,290930148,59874525,231055623
514,520,1999,The Green Mile,290701374,136801374,153900000
515,521,2010,Salt,290650494,118311368,172339126
516,522,2017,Ferdinand,289838913,84410380,205428533
517,523,2006,The Departed,289660619,132384315,157276304
518,524,2011,Bridesmaids,289632023,169211718,120420305
519,525,2007,Fantastic Four: Rise of the Silver Su…,289480691,131921738,157558953
520,526,1988,Coming to America,288800000,128152301,160647699
521,527,2000,What Lies Beneath,288693989,155464351,133229638
522,528,2013,Oblivion,287916633,89107235,198809398
523,529,2007,Bee Movie,287594577,126631277,160963300
524,530,2015,Pitch Perfect 2,287215196,184296230,102918966
525,531,2013,Turbo,286896578,83028130,203868448
526,532,2001,American Pie 2,286500000,145096820,141403180
527,533,1965,The Sound of Music,286214195,163214286,122999909
528,534,2013,Elysium,286192091,93050117,193141974
529,535,1998,Lethal Weapon 4,285400000,130444603,154955397
530,536,2005,Wedding Crashers,283218368,209218368,74000000
531,537,1994,Speed,283200000,121248145,161951855
532,538,2012,John Carter,282778100,73058679,209719421
533,539,1977,Saturday Night Fever,282400000,139486124,142913876
534,540,1995,Casper,282300000,100328194,181971806
535,541,2012,The Bourne Legacy,280355920,113203870,167152050
536,542,1998,Shakespeare in Love,279500000,100317794,179182206
537,543,2017,Split,278754594,138141585,140613009
538,544,2010,The Tourist,278731369,67631157,211100212
539,545,2001,Bridget Jones's Diary,277902373,71500556,206401817
540,546,2000,Scary Movie,277200000,157019771,120180229
541,547,2016,Alice Through the Looking Glass,276928112,77042381,199885731
542,548,1987,Beverly Hills Cop II,276665036,153665036,123000000
543,549,2002,Scooby-Doo,276294164,153294164,123000000
544,550,2014,Divergent,276014965,150947895,125067070
545,551,1991,The Silence of the Lambs,275726716,130726716,145000000
546,552,2008,Gran Torino,274543085,148095302,126447783
547,553,2008,High School Musical 3: Senior Year,274392880,90559416,183833464
548,554,2013,Cloudy with a Chance of Meatballs 2,274392649,119793567,154599082
549,555,1996,The Nutty Professor,273814019,128814019,145000000
550,556,1996,Jerry Maguire,273552592,153952592,119600000
551,557,2018,Tomb Raider,273477501,58250803,215226698
552,558,2012,Lincoln,273346281,182207973,91138308
553,559,2001,Lara Croft: Tomb Raider,273330185,131144183,142186002
554,560,2003,Bad Boys II,273271982,138540870,134731112
555,561,2010,Grown Ups,272223000,162001186,110221814
556,562,2009,The Princess and the Frog,270997378,104400899,166596479
557,563,2014,Neighbors,270944428,150086800,120857628
558,564,1993,The Firm,270340892,158340892,112000000
559,565,2014,Mr. Peabody & Sherman,269806430,111506430,158300000
560,566,2008,"10,000 B.C.",269065678,94784201,174281477
561,567,2021,A Quiet Place: Part II,268625879,159578799,109047080
562,568,1972,The Godfather,268500000,134966411,133533589
563,569,2014,Exodus: Gods and Kings,268314513,65014513,203300000
564,570,2010,The Expendables,268268174,103068524,165199650
565,571,1942,Bambi,268000000,102797000,165203000
566,572,2007,American Gangster,267985456,130164645,137820811
567,573,2013,Weâre the Millers,267816276,150394119,117422157
568,574,2002,xXx,267200000,141930000,125270000
569,575,1992,Batman Returns,266824291,162833635,103990656
570,576,2003,Something's Gotta Give,266685242,124685242,142000000
571,577,1993,Indecent Proposal,266600000,106614059,159985941
572,578,2018,Maze Runner: The Death Cure,265878536,58032443,207846093
573,579,2008,The Incredible Hulk,265573859,134806913,130766946
574,580,1995,Waterworld,264246220,88246220,176000000
575,581,1998,The Truman Show,264118201,125618201,138500000
576,582,1997,The Fifth Element,263898761,63570862,200327899
577,583,2004,Bridget Jones: The Edge Of Reason,263894551,40203020,223691531
578,584,2011,Real Steel,263880341,85463309,178417032
579,585,1950,Cinderella,263591415,85000000,178591415
580,586,2017,Baahubali 2: The Conclusion,263502914,18985794,244517120
581,587,2013,Epic,262794441,107518682,155275759
582,588,1995,Jumanji,262758310,100458310,162300000
583,589,2006,Borat,261443242,128505958,132937284
584,590,1990,Total Recall,261400000,119394839,142005161
585,591,1997,The Full Monty,261249383,45950122,215299261
586,592,2005,Robots,260636271,128200012,132436259
587,593,2013,The Lone Ranger,260002115,89302115,170700000
588,594,2000,Charlie's Angels,259736090,125305545,134430545
589,595,2017,Blade Runner 2049,259238971,92054159,167184812
590,596,2010,Knight and Day,258751370,76423035,182328335
591,597,1985,Out of Africa,258210860,79096868,179113992
592,598,2011,Super 8,257972745,127004179,130968566
593,599,2013,American Hustle,257858943,150098456,107760487
594,600,2000,Erin Brockovich,257805243,125548685,132256558
